Samuel Garcia	samuel.garcia@mcp.com
Henry Nguyen	henryn@mcp.com
Robert Collins	robert.collins@mcp.com
Mark Allen	allenm@mcp.com
Joshua Flores	floresj@mcp.com
Mary Edwards	mary.edwards57@mcp.com
Stephen Lewis	slewis@mcp.com
Nicholas Wilson	nwilson@mcp.com
Robert Johnson	johnsonr@mcp.com
Deborah Wright	deborahw99@mcp.com
Timothy Carter	timothyc57@mcp.com
Kathleen Kelly	kathleen_kelly@mcp.com
Andrew Ramos	ramosa@mcp.com
Edward Davis	edavis@mcp.com
Amanda Chavez	amanda_chavez@mcp.com
Eric Murphy	emurphy@mcp.com
Anthony Ortiz	anthonyo@mcp.com
Marie Walker	marie.walker@mcp.com
Samuel Sanders	samuel_sanders77@mcp.com
Alexander Roberts	alexanderr@mcp.com
Betty Cooper	betty.cooper@mcp.com
Christina Adams	adamsc@mcp.com
Martha Hill	martha.hill@mcp.com
Michael Reed	michael.reed@mcp.com
Emily Morris	emorris@mcp.com
Timothy Gomez	timothy_gomez54@mcp.com
Mary Torres	maryt92@mcp.com
Shirley Mendoza	mendozas52@mcp.com
Melissa Martin	melissa.martin95@mcp.com
Thomas Sanchez	thomas_sanchez8@mcp.com
Christina Harris	harrisc@mcp.com
Scott Martin	scottm@mcp.com
Tyler Roberts	tyler_roberts72@mcp.com
Thomas Nelson	tnelson@mcp.com
Steven Thomas	sthomas@mcp.com
Raymond Bennett	bennettr@mcp.com
Melissa Cruz	mcruz@mcp.com
Sharon Lewis	lewiss@mcp.com
Mary Alvarez	alvarezm51@mcp.com
Emily Stewart	stewarte98@mcp.com